0010000100
0001001000
1111111111
1011000011
1110000001
1010000001
1110000001
1111000011
1111111111
0100000010