11100101
00111010
11011100
10110010
10100000
